1111111111111111111111111111111111111111111
1E0000000000000C00000C000000000000010C00001
1010010100100000101001000000010100001000001
1010010010101010001001000000010101000000001
1P0000000C00C0000000000000000000C000C001111
1111111111111111111111111111111111111111111